"taxa"	"result.synonym"
"AMPHIBIA_ANURA_RANIDAE_Amolops_gerbillus"	"Rana_gerbillus"
"AMPHIBIA_ANURA_RANIDAE_Amolops_kaulbacki"	NA
"AMPHIBIA_ANURA_RANIDAE_Amolops_longimanus"	NA
"AMPHIBIA_ANURA_RANIDAE_Amolops_minutus"	NA
"AMPHIBIA_ANURA_RHACOPHORIDAE_Buergeria_choui"	NA
"AMPHIBIA_ANURA_BUFONIDAE_Bufo_ailaoanus"	"Torrentophryne_ailaoanus"
"AMPHIBIA_ANURA_BUFONIDAE_Bufo_luchunnicus"	"Torrentophryne_luchunnica"
"AMPHIBIA_ANURA_BUFONIDAE_Bufo_menglianus"	"Torrentophryne_mengliana"
"AMPHIBIA_CAUDATA_SALAMANDRIDAE_Cynops_chenggongensis"	"Hypselotriton_chenggongensis"
"AMPHIBIA_CAUDATA_SALAMANDRIDAE_Cynops_wolterstorffi"	"Hypselotriton_wolterstorffi"
"AMPHIBIA_CAUDATA_SALAMANDRIDAE_Cynops_wolterstorffi"	"Molge_wolterstorffi"
"AMPHIBIA_CAUDATA_SALAMANDRIDAE_Cynops_yunnanensis"	"Cynops_cyanurus"
"AMPHIBIA_CAUDATA_SALAMANDRIDAE_Cynops_yunnanensis"	"Hypselotriton_yunnanensis"
"AMPHIBIA_ANURA_RHACOPHORIDAE_Feihyla_fuhua"	NA
"AMPHIBIA_ANURA_RANIDAE_Hylarana_margariana"	"Rana_margariana"
"AMPHIBIA_ANURA_DICROGLOSSIDAE_Ingerana_reticulata"	"Platymantis_reticulatus"
"AMPHIBIA_ANURA_BUFONIDAE_Ingerophrynus_ledongensis"	"Bufo_ledongensis"
"AMPHIBIA_ANURA_MEGOPHRYIDAE_Leptobrachella_maoershanensis"	"Leptolalax_maoershanensis"
"AMPHIBIA_ANURA_MEGOPHRYIDAE_Leptobrachella_purpura"	"Leptolalax_purpurus"
"AMPHIBIA_ANURA_MEGOPHRYIDAE_Leptobrachella_sungi"	"Leptolalax_sungi"
"AMPHIBIA_ANURA_MEGOPHRYIDAE_Leptobrachella_tengchongensis"	"Leptolalax_tengchongensis"
"AMPHIBIA_ANURA_DICROGLOSSIDAE_Limnonectes_liui"	"Ingerana_liui"
"AMPHIBIA_ANURA_DICROGLOSSIDAE_Limnonectes_liui"	"Leptopelis_liui"
"AMPHIBIA_ANURA_DICROGLOSSIDAE_Limnonectes_liui"	"Platymantis_liui"
"AMPHIBIA_ANURA_MEGOPHRYIDAE_Megophrys_feii"	NA
"AMPHIBIA_ANURA_MEGOPHRYIDAE_Megophrys_koui"	"Ophryophryne_pachyproctus"
"AMPHIBIA_ANURA_MEGOPHRYIDAE_Megophrys_liboensis"	"Xenophrys_liboensis"
"AMPHIBIA_ANURA_MEGOPHRYIDAE_Megophrys_shuichengensis"	"Xenophrys_shuichengensis"
"AMPHIBIA_ANURA_DICROGLOSSIDAE_Nanorana_feae"	"Paa_feae"
"AMPHIBIA_ANURA_DICROGLOSSIDAE_Nanorana_minica"	"Paa_minica_minica"
"AMPHIBIA_ANURA_DICROGLOSSIDAE_Nanorana_minica"	"Rana_minica"
"AMPHIBIA_ANURA_DICROGLOSSIDAE_Nanorana_minica"	"Rana_tuberculata"
"AMPHIBIA_ANURA_RANIDAE_Odorrana_cangyuanensis"	"Rana_cangyuanensis"
"AMPHIBIA_ANURA_DICROGLOSSIDAE_Ombrana_sikimensis"	"Rana_assamensis"
"AMPHIBIA_ANURA_DICROGLOSSIDAE_Ombrana_sikimensis"	"Rana_sikimensis"
"AMPHIBIA_ANURA_MEGOPHRYIDAE_Oreolalax_granulosus"	NA
"AMPHIBIA_ANURA_MEGOPHRYIDAE_Oreolalax_puxiongensis"	NA
"AMPHIBIA_ANURA_MEGOPHRYIDAE_Oreolalax_weigoldi"	"Megalophrys_weigoldi"
"AMPHIBIA_ANURA_RANIDAE_Papurana_milleti"	"Hylarana_milleti"
"AMPHIBIA_ANURA_RANIDAE_Papurana_milleti"	"Indosylvirana_milleti"
"AMPHIBIA_ANURA_RANIDAE_Papurana_milleti"	"Rana_bannanica"
"AMPHIBIA_ANURA_RANIDAE_Papurana_milleti"	"Rana_milleti"
"AMPHIBIA_ANURA_RANIDAE_Pelophylax_tenggerensis"	"Rana_tenggerensis"
"AMPHIBIA_ANURA_RHACOPHORIDAE_Philautus_kempii"	NA
"AMPHIBIA_ANURA_RHACOPHORIDAE_Philautus_maosonensis"	NA
"AMPHIBIA_ANURA_RHACOPHORIDAE_Philautus_tytthus"	NA
"AMPHIBIA_ANURA_DICROGLOSSIDAE_Quasipaa_acanthophora"	NA
"AMPHIBIA_ANURA_RANIDAE_Rana_chevronta"	NA
"AMPHIBIA_ANURA_RANIDAE_Rana_luanchuanensis"	NA
"AMPHIBIA_ANURA_RHACOPHORIDAE_Raorchestes_andersoni"	"Ixalus_tuberculatus"
"AMPHIBIA_ANURA_RHACOPHORIDAE_Raorchestes_andersoni"	"Philautus_andersoni"
"AMPHIBIA_ANURA_RHACOPHORIDAE_Raorchestes_andersoni"	"Theloderma_andersoni"
"AMPHIBIA_ANURA_RHACOPHORIDAE_Rhacophorus_laoshan"	NA
"AMPHIBIA_ANURA_MEGOPHRYIDAE_Scutiger_adungensis"	NA
"AMPHIBIA_ANURA_MEGOPHRYIDAE_Scutiger_brevipes"	"Aelurophryne_brevipes"
"AMPHIBIA_ANURA_MEGOPHRYIDAE_Scutiger_maculatus"	"Aelurophryne_maculata"
"AMPHIBIA_ANURA_MEGOPHRYIDAE_Scutiger_pingwuensis"	NA
"AMPHIBIA_ANURA_MEGOPHRYIDAE_Scutiger_wanglangensis"	NA
"AMPHIBIA_ANURA_RHACOPHORIDAE_Zhangixalus_arvalis"	"Rhacophorus_arvalis"
"AMPHIBIA_ANURA_RHACOPHORIDAE_Zhangixalus_aurantiventris"	"Rhacophorus_aurantiventris"
"AMPHIBIA_ANURA_RHACOPHORIDAE_Zhangixalus_chenfui"	"Polypedates_chenfui"
"AMPHIBIA_ANURA_RHACOPHORIDAE_Zhangixalus_chenfui"	"Rhacophorus_chenfui"
"AMPHIBIA_ANURA_RHACOPHORIDAE_Zhangixalus_dennysi"	"Rhacophorus_dennysi"
"AMPHIBIA_ANURA_RHACOPHORIDAE_Zhangixalus_hui"	"Polypedates_zhaojuensis"
"AMPHIBIA_ANURA_RHACOPHORIDAE_Zhangixalus_hui"	"Rhacophorus_hui"
"AMPHIBIA_ANURA_RHACOPHORIDAE_Zhangixalus_hui"	"Rhacophorus_zhaojuensis"
"AMPHIBIA_ANURA_RHACOPHORIDAE_Zhangixalus_hungfuensis"	"Polypedates_hungfuensis"
"AMPHIBIA_ANURA_RHACOPHORIDAE_Zhangixalus_hungfuensis"	"Rhacophorus_hungfuensis"
"AMPHIBIA_ANURA_RHACOPHORIDAE_Zhangixalus_leucofasciatus"	"Rhacophorus_leucofasciatus"
"AMPHIBIA_ANURA_RHACOPHORIDAE_Zhangixalus_lishuiensis"	"Rhacophorus_lishuiensis"
"AMPHIBIA_ANURA_RHACOPHORIDAE_Zhangixalus_minimus"	"Rhacophorus_minimus"
"AMPHIBIA_ANURA_RHACOPHORIDAE_Zhangixalus_nigropunctatus"	"Polypedates_nigropunctatus"
"AMPHIBIA_ANURA_RHACOPHORIDAE_Zhangixalus_nigropunctatus"	"Rhacophorus_nigropunctatus"
"AMPHIBIA_ANURA_RHACOPHORIDAE_Zhangixalus_prasinatus"	"Rhacophorus_prasinatus"
"AMPHIBIA_ANURA_RHACOPHORIDAE_Zhangixalus_prasinatus"	"Rhacophorus_smaragdinus"
"AMPHIBIA_ANURA_RHACOPHORIDAE_Zhangixalus_wui"	"Rhacophorus_wui"
"AMPHIBIA_ANURA_RHACOPHORIDAE_Zhangixalus_yaoshanensis"	"Polypedates_yaoshanensis"
"AMPHIBIA_ANURA_RHACOPHORIDAE_Zhangixalus_yaoshanensis"	"Rhacophorus_yaoshanensis"
"AMPHIBIA_ANURA_RHACOPHORIDAE_Zhangixalus_yinggelingensis"	"Rhacophorus_yinggelingensis"
"AVES_PASSERIFORMES_STURNIDAE_Acridotheres_burmannicus"	NA
"AVES_PASSERIFORMES_LEIOTRICHIDAE_Actinodura_radcliffei"	NA
"AVES_PASSERIFORMES_AEGITHALIDAE_Aegithalos_iredalei"	NA
"AVES_PASSERIFORMES_NECTARINIIDAE_Aethopyga_latouchii"	NA
"AVES_PASSERIFORMES_FRINGILLIDAE_Agraphospiza_rubescens"	"Carpodacus_rubescens"
"AVES_PASSERIFORMES_STURNIDAE_Agropsar_philippensis"	"Sturnus_philippensis"
"AVES_PASSERIFORMES_ALAUDIDAE_Alauda_leucoptera"	"Melanocorypha_leucoptera"
"AVES_PASSERIFORMES_ALAUDIDAE_Alaudala_rufescens"	"Alaudala_cheleensis"
"AVES_PASSERIFORMES_PYCNONOTIDAE_Alcurus_striatus"	"Pycnonotus_striatus"
"AVES_PSITTACIFORMES_PSITTACIDAE_Alexandrinus_krameri"	"Psittacula_krameri"
"AVES_ANSERIFORMES_ANATIDAE_Anser_cygnoid"	"Anser_cygnoides"
"AVES_STRIGIFORMES_STRIGIDAE_Bubo_coromandus"	NA
"AVES_CHARADRIIFORMES_SCOLOPACIDAE_Calidris_falcinellus"	"Limicola_falcinellus"
"AVES_PASSERIFORMES_MUSCICAPIDAE_Calliope_tschebaiewi"	NA
"AVES_PASSERIFORMES_FRINGILLIDAE_Carpodacus_dubius"	NA
"AVES_PASSERIFORMES_FRINGILLIDAE_Carpodacus_sipahi"	"Haematospiza_sipahi"
"AVES_PASSERIFORMES_FRINGILLIDAE_Carpodacus_stoliczkae"	NA
"AVES_PASSERIFORMES_FRINGILLIDAE_Carpodacus_subhimachalus"	"Pinicola_subhimachala"
"AVES_PASSERIFORMES_FRINGILLIDAE_Carpodacus_subhimachalus"	"Pinicola_subhimachalus_"
"AVES_PASSERIFORMES_FRINGILLIDAE_Carpodacus_verreauxii"	NA
"AVES_PASSERIFORMES_FRINGILLIDAE_Carpodacus_waltoni"	NA
"AVES_PASSERIFORMES_SYLVIIDAE_Chleuasicus_atrosuperciliaris"	"Paradoxornis_atrosuperciliaris"
"AVES_PASSERIFORMES_CHLOROPSEIDAE_Chloropsis_lazulina"	NA
"AVES_PASSERIFORMES_CHLOROPSEIDAE_Chloropsis_moluccensis"	NA
"AVES_PASSERIFORMES_SYLVIIDAE_Cholornis_paradoxus"	"Paradoxornis_paradoxus"
"AVES_PICIFORMES_PICIDAE_Chrysocolaptes_guttacristatus"	NA
"AVES_COLUMBIFORMES_COLUMBIDAE_Columba_eversmanni"	NA
"AVES_COLUMBIFORMES_COLUMBIDAE_Columba_punicea"	NA
"AVES_CORACIIFORMES_CORACIIDAE_Coracias_affinis"	NA
"AVES_PASSERIFORMES_MUSCICAPIDAE_Cyanecula_svecica"	"Luscinia_svecica"
"AVES_PASSERIFORMES_TIMALIIDAE_Cyanoderma_chrysaeum"	"Stachyris_chrysaea"
"AVES_PASSERIFORMES_MUSCICAPIDAE_Cyornis_brunneatus"	NA
"AVES_PASSERIFORMES_HIRUNDINIDAE_Delichon_lagopodum"	NA
"AVES_PASSERIFORMES_HIRUNDINIDAE_Delichon_nipalense"	"Delichon_nipalensis_"
"AVES_PASSERIFORMES_DICRURIDAE_Dicrurus_annectens"	"Dicrurus_annectans"
"AVES_PICIFORMES_PICIDAE_Dryobates_pernyii"	NA
"AVES_PASSERIFORMES_EMBERIZIDAE_Emberiza_lathami"	"Melophus_lathami"
"AVES_PASSERIFORMES_TIMALIIDAE_Erythrogenys_erythrocnemis"	"Pomatorhinus_erythrocnemis"
"AVES_PASSERIFORMES_TIMALIIDAE_Erythrogenys_hypoleucos"	"Pomatorhinus_hypoleucos"
"AVES_CHARADRIIFORMES_BURHINIDAE_Esacus_recurvirostris"	"Burhinus_recurvirostris"
"AVES_PASSERIFORMES_MUSCICAPIDAE_Ficedula_erithacus"	"Ficedula_sordida"
"AVES_PASSERIFORMES_MUSCICAPIDAE_Ficedula_hodgsoni"	"Muscicapella_hodgsoni"
"AVES_PASSERIFORMES_SYLVIIDAE_Fulvetta_striaticollis"	"Alcippe_striaticollis"
"AVES_CHARADRIIFORMES_SCOLOPACIDAE_Gallinago_nemoricola"	NA
"AVES_PASSERIFORMES_PELLORNEIDAE_Gampsorhynchus_torquatus"	NA
"AVES_PASSERIFORMES_LEIOTRICHIDAE_Garrulax_cinereiceps"	NA
"AVES_PASSERIFORMES_LEIOTRICHIDAE_Garrulax_monachus"	NA
"AVES_PASSERIFORMES_LEIOTRICHIDAE_Garrulax_ruficeps"	NA
"AVES_PASSERIFORMES_CORVIDAE_Garrulus_bispecularis"	NA
"AVES_PASSERIFORMES_CORVIDAE_Garrulus_leucotis"	NA
"AVES_CHARADRIIFORMES_GLAREOLIDAE_Glareola_lactea"	NA
"AVES_PASSERIFORMES_PELLORNEIDAE_Graminicola_striatus"	NA
"AVES_PASSERIFORMES_LOCUSTELLIDAE_Helopsaltes_certhiola"	"Locustella_certhiola"
"AVES_PASSERIFORMES_LOCUSTELLIDAE_Helopsaltes_fasciolata"	"Locustella_fasciolata"
"AVES_PASSERIFORMES_LOCUSTELLIDAE_Helopsaltes_ochotensis"	"Locustella_ochotensis"
"AVES_PASSERIFORMES_LOCUSTELLIDAE_Helopsaltes_pleskei"	"Locustella_pleskei"
"AVES_PASSERIFORMES_LOCUSTELLIDAE_Helopsaltes_pryeri"	"Locustella_pryeri"
"AVES_PASSERIFORMES_LOCUSTELLIDAE_Helopsaltes_pryeri"	"Megalurus_pryeri"
"AVES_CAPRIMULGIFORMES_HEMIPROCNIDAE_Hemiprocne_coronata"	NA
"AVES_PASSERIFORMES_SCOTOCERCIDAE_Hemitesia_pallidipes"	"Cettia_pallidipes"
"AVES_PSITTACIFORMES_PSITTACIDAE_Himalayapsitta_finschii"	"Psittacula_finschii"
"AVES_PSITTACIFORMES_PSITTACIDAE_Himalayapsitta_roseata"	"Psittacula_roseata"
"AVES_CAPRIMULGIFORMES_APODIDAE_Hirundapus_cochinchinensis"	NA
"AVES_PASSERIFORMES_PITTIDAE_Hydrornis_cyaneus"	"Pitta_cyanea"
"AVES_ACCIPITRIFORMES_ACCIPITRIDAE_Icthyophaga_humilis"	"Ichthyophaga_humilis"
"AVES_ACCIPITRIFORMES_ACCIPITRIDAE_Ictinaetus_malaiensis"	"Ictinaetus_malayensis"
"AVES_PASSERIFORMES_MUSCICAPIDAE_Kittacincla_malabarica"	NA
"AVES_PASSERIFORMES_NECTARINIIDAE_Kurochkinegramma_hypogrammica"	"Arachnothera_hypogrammica"
"AVES_PASSERIFORMES_NECTARINIIDAE_Kurochkinegramma_hypogrammica"	"Arachnothera_hypogrammicum"
"AVES_PASSERIFORMES_NECTARINIIDAE_Kurochkinegramma_hypogrammica"	"Hypogramma_hypogrammicum"
"AVES_PASSERIFORMES_CAMPEPHAGIDAE_Lalage_melaschistos"	"Coracina_melaschistos"
"AVES_PASSERIFORMES_LANIIDAE_Lanius_borealis"	NA
"AVES_PASSERIFORMES_LANIIDAE_Lanius_giganteus"	NA
"AVES_PASSERIFORMES_LANIIDAE_Lanius_phoenicuroides"	NA
"AVES_PASSERIFORMES_MUSCICAPIDAE_Larvivora_cyane"	"Luscinia_cyane"
"AVES_GRUIFORMES_GRUIDAE_Leucogeranus_leucogeranus"	"Grus_leucogeranus"
"AVES_PASSERIFORMES_LOCUSTELLIDAE_Locustella_alishanensis"	"Bradypterus_alishanensis"
"AVES_PASSERIFORMES_LOCUSTELLIDAE_Locustella_davidi"	"Bradypterus_davidi"
"AVES_PASSERIFORMES_LOCUSTELLIDAE_Locustella_luteoventris"	"Bradypterus_luteoventris"
"AVES_PASSERIFORMES_LOCUSTELLIDAE_Locustella_major"	"Bradypterus_major"
"AVES_PASSERIFORMES_LOCUSTELLIDAE_Locustella_tacsanowskia"	"Bradypterus_tacsanowskius"
"AVES_PASSERIFORMES_LOCUSTELLIDAE_Locustella_thoracica"	NA
"AVES_ANSERIFORMES_ANATIDAE_Melanitta_stejnegeri"	"Melanitta_fusca"
"AVES_PASSERIFORMES_MUSCICAPIDAE_Myophonus_insularis"	NA
"AVES_PASSERIFORMES_SYLVIIDAE_Neosuthora_davidiana"	"Paradoxornis_davidianus"
"AVES_PASSERIFORMES_MUSCICAPIDAE_Niltava_oatesi"	NA
"AVES_PELECANIFORMES_ARDEIDAE_Oroanassa_magnifica"	"Gorsachius_magnificus"
"AVES_PELECANIFORMES_ARDEIDAE_Oroanassa_magnifica"	"Nycticorax_magnificus"
"AVES_PASSERIFORMES_TURDIDAE_Otocichla_mupinensis"	"Turdus_mupinensis"
"AVES_PASSERIFORMES_PASSERIDAE_Passer_cinnamomeus"	NA
"AVES_CUCULIFORMES_CUCULIDAE_Phaenicophaeus_tristis"	NA
"AVES_PASSERIFORMES_PHYLLOSCOPIDAE_Phylloscopus_intensior"	"Phylloscopus_davisoni"
"AVES_PASSERIFORMES_PHYLLOSCOPIDAE_Phylloscopus_intermedius"	"Seicercus_affinis"
"AVES_PASSERIFORMES_PHYLLOSCOPIDAE_Phylloscopus_tristis"	NA
"AVES_PICIFORMES_PICIDAE_Picoides_funebris"	NA
"AVES_PICIFORMES_PICIDAE_Picus_guerini"	NA
"AVES_PASSERIFORMES_TIMALIIDAE_Pomatorhinus_phayrei"	NA
"AVES_PASSERIFORMES_CISTICOLIDAE_Prinia_sonitans"	NA
"AVES_PICIFORMES_MEGALAIMIDAE_Psilopogon_asiaticus"	NA
"AVES_PICIFORMES_MEGALAIMIDAE_Psilopogon_cyanotis"	NA
"AVES_PICIFORMES_MEGALAIMIDAE_Psilopogon_faber"	"Megalaima_faber"
"AVES_PICIFORMES_MEGALAIMIDAE_Psilopogon_faiostrictus"	"Megalaima_faiostricta"
"AVES_PICIFORMES_MEGALAIMIDAE_Psilopogon_franklinii"	NA
"AVES_PICIFORMES_MEGALAIMIDAE_Psilopogon_lineatus"	"Megalaima_lineata"
"AVES_PASSERIFORMES_SYLVIIDAE_Psittiparus_bakeri"	"Paradoxornis_bakeri"
"AVES_GRUIFORMES_RALLIDAE_Rallus_indicus"	NA
"AVES_COLUMBIFORMES_COLUMBIDAE_Ramphiculus_leclancheri"	"Ptilinopus_leclancheri"
"AVES_PASSERIFORMES_SYLVIIDAE_Rhopophilus_albosuperciliaris"	NA
"AVES_PASSERIFORMES_PYCNONOTIDAE_Rubigula_flaviventris"	"Pycnonotus_flaviventris"
"AVES_PASSERIFORMES_PELLORNEIDAE_Schoeniparus_brunneus"	"Alcippe_brunnea"
"AVES_PASSERIFORMES_PELLORNEIDAE_Schoeniparus_cinereus"	"Alcippe_cinerea"
"AVES_PASSERIFORMES_PELLORNEIDAE_Schoeniparus_dubius"	"Alcippe_dubia"
"AVES_PASSERIFORMES_LEIOTRICHIDAE_Sibia_morrisoniana"	"Actinodura_morrisoniana"
"AVES_PASSERIFORMES_LEIOTRICHIDAE_Sibia_waldeni"	"Actinodura_waldeni"
"AVES_PASSERIFORMES_SYLVIIDAE_Sinosuthora_brunnea"	NA
"AVES_PASSERIFORMES_SYLVIIDAE_Sinosuthora_przewalskii"	"Paradoxornis_przewalskii"
"AVES_PASSERIFORMES_SYLVIIDAE_Sinosuthora_ricketti"	NA
"AVES_PASSERIFORMES_SITTIDAE_Sitta_solangiae"	NA
"AVES_PASSERIFORMES_TIMALIIDAE_Spelaeornis_reptatus"	NA
"AVES_PASSERIFORMES_FRINGILLIDAE_Spinus_thibetanus"	"Serinus_thibetanus"
"AVES_PASSERIFORMES_STURNIDAE_Spodiopsar_cineraceus"	"Sturnus_cineraceus"
"AVES_PASSERIFORMES_STURNIDAE_Spodiopsar_sericeus"	"Sturnus_sericeus"
"AVES_PASSERIFORMES_TIMALIIDAE_Stachyris_roberti"	"Sphenocichla_roberti"
"AVES_CUCULIFORMES_CUCULIDAE_Surniculus_dicruroides"	NA
"AVES_PASSERIFORMES_SYLVIIDAE_Suthora_fulvifrons"	"Paradoxornis_fulvifrons"
"AVES_PASSERIFORMES_SYLVIIDAE_Suthora_verreauxi"	"Paradoxornis_verreauxi"
"AVES_GALLIFORMES_PHASIANIDAE_Synoicus_chinensis"	"Coturnix_chinensis_old"
"AVES_PTEROCLIFORMES_PTEROCLIDAE_Syrrhaptes_tibetanus"	NA
"AVES_PASSERIFORMES_MONARCHIDAE_Terpsiphone_affinis"	NA
"AVES_PASSERIFORMES_MONARCHIDAE_Terpsiphone_incei"	NA
"AVES_PASSERIFORMES_PELLORNEIDAE_Trichastoma_tickelli"	NA
"AVES_PASSERIFORMES_PELLORNEIDAE_Turdinus_crispifrons"	"Gypsophila_crispifrons"
"AVES_PASSERIFORMES_CORVIDAE_Urocissa_whiteheadi"	NA
"AVES_PASSERIFORMES_CORVIDAE_Urocissa_xanthomelana"	NA
"AVES_CHARADRIIFORMES_CHARADRIIDAE_Vanellus_duvaucelii"	NA
"AVES_CHARADRIIFORMES_CHARADRIIDAE_Vanellus_gregarius"	"Chettusia_gregaria"
"AVES_PASSERIFORMES_ZOSTEROPIDAE_Yuhina_torqueola"	NA
"AVES_GRUIFORMES_RALLIDAE_Zapornia_akool"	"Amaurornis_akool"
"AVES_GRUIFORMES_RALLIDAE_Zapornia_bicolor"	"Amaurornis_bicolor"
"AVES_GRUIFORMES_RALLIDAE_Zapornia_paykullii"	"Porzana_paykullii"
"AVES_GRUIFORMES_RALLIDAE_Zapornia_pusilla"	"Porzana_pusilla"
"MAMMALIA_CARNIVORA_MUSTELIDAE_Arctonyx_albogularis"	"Arctonyx_collaris"
"MAMMALIA_CARNIVORA_MUSTELIDAE_Arctonyx_albogularis"	"Arctonyx_isonyx"
"MAMMALIA_CARNIVORA_MUSTELIDAE_Arctonyx_albogularis"	"Arctonyx_leucolaemus"
"MAMMALIA_CARNIVORA_MUSTELIDAE_Arctonyx_albogularis"	"Arctonyx_obscurus"
"MAMMALIA_CARNIVORA_MUSTELIDAE_Arctonyx_albogularis"	"Arctonyx_taxoides"
"MAMMALIA_CARNIVORA_MUSTELIDAE_Arctonyx_albogularis"	"Meles_albogularis"
"MAMMALIA_CARNIVORA_MUSTELIDAE_Arctonyx_albogularis"	"Meles_leucolaemus"
"MAMMALIA_RODENTIA_MURIDAE_Berylmys_mackenziei"	NA
"MAMMALIA_RODENTIA_GLIRIDAE_Chaetocauda_sichuanensis"	"Dryomys_sichuanensis"
"MAMMALIA_EULIPOTYPHLA_SORICIDAE_Chodsigoa_lamula"	"Soriculus_lamula"
"MAMMALIA_EULIPOTYPHLA_SORICIDAE_Chodsigoa_salenskii"	"Soriculus_salenskii"
"MAMMALIA_RODENTIA_CRICETIDAE_Cricetulus_tibetanus"	NA
"MAMMALIA_EULIPOTYPHLA_SORICIDAE_Crocidura_gmelini"	NA
"MAMMALIA_CHIROPTERA_VESPERTILIONIDAE_Eptesicus_pachyomus"	NA
"MAMMALIA_CHIROPTERA_VESPERTILIONIDAE_Eptesicus_pachyotis"	"Vesperugo_pachyotis"
"MAMMALIA_RODENTIA_MURIDAE_Hadromys_yunnanensis"	NA
"MAMMALIA_CHIROPTERA_HIPPOSIDERIDAE_Hipposideros_gentilis"	NA
"MAMMALIA_CHIROPTERA_VESPERTILIONIDAE_Hypsugo_affinis"	"Falsistrellus_affinis"
"MAMMALIA_CHIROPTERA_VESPERTILIONIDAE_Hypsugo_affinis"	"Pipistrellus_affinis"
"MAMMALIA_CHIROPTERA_VESPERTILIONIDAE_Hypsugo_affinis"	"Vesperugo_affinis"
"MAMMALIA_CHIROPTERA_MEGADERMATIDAE_Lyroderma_lyra"	"Encheira_lyra"
"MAMMALIA_CHIROPTERA_MEGADERMATIDAE_Lyroderma_lyra"	"Megaderma_lyra"
"MAMMALIA_CHIROPTERA_MEGADERMATIDAE_Lyroderma_lyra"	"Megaderma_spectrum"
"MAMMALIA_CHIROPTERA_MEGADERMATIDAE_Lyroderma_lyra"	"Vespertilio_carnatica"
"MAMMALIA_CHIROPTERA_VESPERTILIONIDAE_Murina_fusca"	NA
"MAMMALIA_CARNIVORA_MUSTELIDAE_Mustela_russelliana"	NA
"MAMMALIA_RODENTIA_SCIURIDAE_Petaurista_magnificus"	NA
"MAMMALIA_RODENTIA_SCIURIDAE_Petaurista_mechukaensis"	NA
"MAMMALIA_RODENTIA_SCIURIDAE_Petaurista_mishmiensis"	NA
"MAMMALIA_RODENTIA_SCIURIDAE_Petaurista_nobilis"	NA
"MAMMALIA_CHIROPTERA_VESPERTILIONIDAE_Pipistrellus_aladdin"	NA
"MAMMALIA_CHIROPTERA_VESPERTILIONIDAE_Plecotus_ariel"	NA
"MAMMALIA_CHIROPTERA_VESPERTILIONIDAE_Plecotus_taivanus"	NA
"MAMMALIA_CHIROPTERA_RHINOLOPHIDAE_Rhinolophus_schnitzleri"	NA
"MAMMALIA_CHIROPTERA_RHINOLOPHIDAE_Rhinolophus_subbadius"	NA
"MAMMALIA_CHIROPTERA_RHINOLOPHIDAE_Rhinolophus_yunanensis"	"MAMMALIA_CHIROPTERA_RHINOLOPHIDAE_Rhinolophus_yunnanensis"
"MAMMALIA_RODENTIA_GLIRIDAE_Selevinia_betpakdalaensis"	NA
"MAMMALIA_RODENTIA_DIPODIDAE_Sicista_pseudonapaea"	NA
"MAMMALIA_EULIPOTYPHLA_SORICIDAE_Sorex_kozlovi"	NA
"MAMMALIA_EULIPOTYPHLA_SORICIDAE_Sorex_planiceps"	NA
"MAMMALIA_RODENTIA_SCIURIDAE_Spermophilus_ralli"	NA
"MAMMALIA_CHIROPTERA_VESPERTILIONIDAE_Tylonycteris_pygmaeus"	NA
"REPTILIA_SQUAMATA_XENODERMIDAE_Achalinus_hainanus"	NA
"REPTILIA_SQUAMATA_XENODERMIDAE_Achalinus_jinggangensis"	NA
"REPTILIA_SQUAMATA_GEKKONIDAE_Alsophylax_przewalskii"	NA
"REPTILIA_SQUAMATA_NATRICIDAE_Amphiesmoides_ornaticeps"	NA
"REPTILIA_SQUAMATA_TYPHLOPIDAE_Argyrophis_koshunensis"	NA
"REPTILIA_SQUAMATA_GEKKONIDAE_Cyrtodactylus_medogensis"	NA
"REPTILIA_SQUAMATA_COLUBRIDAE_Dendrelaphis_gorei"	NA
"REPTILIA_SQUAMATA_COLUBRIDAE_Dendrelaphis_hollinrakei"	NA
"REPTILIA_SQUAMATA_AGAMIDAE_Diploderma_brevicauda"	NA
"REPTILIA_SQUAMATA_AGAMIDAE_Diploderma_grahami"	NA
"REPTILIA_SQUAMATA_ANGUIDAE_Dopasia_ludovici"	NA
"REPTILIA_SQUAMATA_LACERTIDAE_Eremias_kokshaaliensis"	NA
"REPTILIA_SQUAMATA_LACERTIDAE_Eremias_quadrifrons"	NA
"REPTILIA_SQUAMATA_GEKKONIDAE_Gekko_bannaense"	REPTILIA_SQUAMATA_GEKKONIDAE_Ptychozoon_bannaense
"REPTILIA_SQUAMATA_GEKKONIDAE_Gekko_guishanicus"	NA
"REPTILIA_SQUAMATA_GEKKONIDAE_Gekko_liboensis"	NA
"REPTILIA_SQUAMATA_GEKKONIDAE_Gekko_taibaiensis"	NA
"REPTILIA_SQUAMATA_GEKKONIDAE_Gekko_wenxianensis"	NA
"REPTILIA_SQUAMATA_NATRICIDAE_Hebius_taronensis"	NA
"REPTILIA_SQUAMATA_GEKKONIDAE_Hemidactylus_stejnegeri"	NA
"REPTILIA_SQUAMATA_GEKKONIDAE_Hemidactylus_vietnamensis"	NA
"REPTILIA_SQUAMATA_TYPHLOPIDAE_Indotyphlops_lazelli"	NA
"REPTILIA_SQUAMATA_COLUBRIDAE_Lycodon_davisonii"	NA
"REPTILIA_SQUAMATA_COLUBRIDAE_Oligodon_eberhardti"	NA
"REPTILIA_SQUAMATA_COLUBRIDAE_Oligodon_lungshenensis"	NA
"REPTILIA_SQUAMATA_NATRICIDAE_Paratapinophis_praemaxillaris"	NA
"REPTILIA_SQUAMATA_PSEUDOXENODONTIDAE_Plagiopholis_nuchalis"	NA
"REPTILIA_SQUAMATA_SCINCIDAE_Plestiodon_leucostictus"	NA
"REPTILIA_SQUAMATA_SCINCIDAE_Plestiodon_popei"	NA
"REPTILIA_SQUAMATA_SCINCIDAE_Scincella_barbouri"	NA
"REPTILIA_SQUAMATA_SCINCIDAE_Scincella_monticola"	NA
"REPTILIA_SQUAMATA_SCINCIDAE_Scincella_ochracea"	NA
"REPTILIA_SQUAMATA_SCINCIDAE_Scincella_przewalskii"	NA
"REPTILIA_SQUAMATA_SCINCIDAE_Scincella_schmidti"	NA
"REPTILIA_SQUAMATA_SCINCIDAE_Sphenomorphus_taiwanensis"	NA
"REPTILIA_SQUAMATA_GEKKONIDAE_Tenuidactylus_dadunensis"	NA
"REPTILIA_SQUAMATA_SCINCIDAE_Tropidophorus_guangxiensis"	NA
"REPTILIA_SQUAMATA_Scincidae_Scincella_ladacensis"	NA
"REPTILIA_SQUAMATA_Gecko_Cyrtopodion_medogense"	NA
"REPTILIA_SQUAMATA_Agamidae_Diploderma_fasciatum"	NA
"REPTILIA_SQUAMATA_Scincidae_Sphenomorphus_courcyanum"	NA
"REPTILIA_SQUAMATA_Lacertidae_Eremias_roborowskii"	NA
"REPTILIA_SQUAMATA_Gecko_Goniurosaurus_sinensis"	NA
"REPTILIA_SQUAMATA_Varanidae_Varanus_irrawadicus"	NA
